driver_id	driver_name
Adolf_Brudes	Adolf Brudes
Adolfo_Schwelm_Cruz	Adolfo Schwelm Cruz
Adrian_Campos	Adrian Campos
Adrian_Sutil	Adrian Sutil
Aguri_Suzuki	Aguri Suzuki
A_J_Foyt	A.J. Foyt
Alain_Prost	Alain Prost
Alan_Brown	Alan Brown
Alan_Jones	Alan Jones
Alan_Rees	Alan Rees
Alan_Rollinson	Alan Rollinson
Alan_Stacey	Alan Stacey
Alberto_Ascari	Alberto Ascari
Alberto_Rodriguez_Larreta	Alberto Rodriguez Larreta
Alberto_Uria	Alberto Uria
Albert_Scherrer	Albert Scherrer
Aldo_Gordini	Aldo Gordini
Alejandro_de_Tomaso	Alejandro de Tomaso
Alessandro_Nannini	Alessandro Nannini
Alessandro_Pesenti-Rossi	Alessandro Pesenti-Rossi
Alexander_Albon	Alexander Albon
Alexander_Rossi	Alexander Rossi
Alexander_Wurz	Alexander Wurz
Alex_Caffi	Alex Caffi
Alex_Ribeiro	Alex Ribeiro
Alex_Soler-Roig	Alex Soler-Roig
Alex_Yoong	Alex Yoong
Alex_Zanardi	Alex Zanardi
Alfonso_de_Portago	Alfonso de Portago
Alfonso_Thiele	Alfonso Thiele
Alfredo_Pian	Alfredo Pian
Al_Herman	Al Herman
Al_Keller	Al Keller
Allan_McNish	Allan McNish
Allen_Berg	Allen Berg
Al_Pease	Al Pease
Andrea_Chiesa	Andrea Chiesa
Andrea_de_Adamich	Andrea de Adamich
Andrea_de_Cesaris	Andrea de Cesaris
Andrea_Montermini	Andrea Montermini
Andre_Guelfi	Andre Guelfi
Andre_Lotterer	Andre Lotterer
Andre_Milhoux	Andre Milhoux
Andre_Pilette	Andre Pilette
Andre_Simon	Andre Simon
Andy_Linden	Andy Linden
Anthony_Davidson	Anthony Davidson
Antonio_Creus	Antonio Creus
Antonio_Giovinazzi	Antonio Giovinazzi
Antonio_Pizzonia	Antonio Pizzonia
Archie_Scott_Brown	Archie Scott Brown
Art_Bisch	Art Bisch
Art_Cross	Art Cross
Arthur_Legat	Arthur Legat
Arthur_Owen	Arthur Owen
Arturo_Merzario	Arturo Merzario
Ayrton_Senna	Ayrton Senna
Basil_van_Rooyen	Basil van Rooyen
Bayliss_Levrett	Bayliss Levrett
Ben_Pon	Ben Pon
Beppe_Gabbiani	Beppe Gabbiani
Bernard_Collomb	Bernard Collomb
Bernd_Schneider	Bernd Schneider
Bertil_Roos	Bertil Roos
Bertrand_Gachot	Bertrand Gachot
Bill_Aston	Bill Aston
Bill_Brack	Bill Brack
Bill_Cheesbourg	Bill Cheesbourg
Bill_Holland	Bill Holland
Bill_Homeier	Bill Homeier
Bill_Mackey	Bill Mackey
Bill_Schindler	Bill Schindler
Bill_Vukovich	Bill Vukovich
Bill_Whitehouse	Bill Whitehouse
Billy_Garrett	Billy Garrett
Bob_Anderson	Bob Anderson
Bob_Bondurant	Bob Bondurant
Bobby_Ball	Bobby Ball
Bobby_Grim	Bobby Grim
Bobby_Rahal	Bobby Rahal
Bobby_Unser	Bobby Unser
Bob_Christie	Bob Christie
Bob_Drake	Bob Drake
Bob_Evans	Bob Evans
Bob_Gerard	Bob Gerard
Bob_Said	Bob Said
Bob_Scott	Bob Scott
Bob_Sweikert	Bob Sweikert
Bob_Veith	Bob Veith
Boy_Hayje	Boy Hayje
Brausch_Niemann	Brausch Niemann
Brendon_Hartley	Brendon Hartley
Brett_Lunger	Brett Lunger
Brian_Henton	Brian Henton
Brian_Naylor	Brian Naylor
Brian_Redman	Brian Redman
Brian_Shawe-Taylor	Brian Shawe-Taylor
Bruce_Halford	Bruce Halford
Bruce_Johnstone	Bruce Johnstone
Bruce_McLaren	Bruce McLaren
Bruno_Giacomelli	Bruno Giacomelli
Bruno_Senna	Bruno Senna
Bud_Tingelstad	Bud Tingelstad
Cal_Niday	Cal Niday
Carel_Godin_de_Beaufort	Carel Godin de Beaufort
Carl_Forberg	Carl Forberg
Carlos_Menditeguy	Carlos Menditeguy
Carlos_Pace	Carlos Pace
Carlos_Reutemann	Carlos Reutemann
Carlos_Sainz_Jr	Carlos Sainz, Jr.
Carl_Scarborough	Carl Scarborough
Carroll_Shelby	Carroll Shelby
Cecil_Green	Cecil Green
Cesare_Perdisa	Cesare Perdisa
Charles_de_Tornaco	Charles de Tornaco
Charles_Leclerc	Charles Leclerc
Charles_Pic	Charles Pic
Charles_Pozzi	Charles Pozzi
Chet_Miller	Chet Miller
Chico_Landi	Chico Landi
Chico_Serra	Chico Serra
Chris_Amon	Chris Amon
Chris_Bristow	Chris Bristow
Chris_Craft	Chris Craft
Chris_Irwin	Chris Irwin
Chris_Lawrence	Chris Lawrence
Christian_Danner	Christian Danner
Christian_Fittipaldi	Christian Fittipaldi
Christian_Goethals	Christian Goethals
Christian_Klien	Christian Klien
Christijan_Albers	Christijan Albers
Chuck_Arnold	Chuck Arnold
Chuck_Daigh	Chuck Daigh
Chuck_Stevenson	Chuck Stevenson
Chuck_Weyant	Chuck Weyant
Clay_Regazzoni	Clay Regazzoni
Clemar_Bucci	Clemar Bucci
Clemente_Biondetti	Clemente Biondetti
Cliff_Allison	Cliff Allison
Cliff_Griffith	Cliff Griffith
Colin_Chapman	Colin Chapman
Colin_Davis	Colin Davis
Conny_Andersson	Conny Andersson
Consalvo_Sanesi	Consalvo Sanesi
Corrado_Fabi	Corrado Fabi
Cristiano_da_Matta	Cristiano da Matta
Cuth_Harrison	Cuth Harrison
Damien_Magee	Damien Magee
Damon_Hill	Damon Hill
Dan_Gurney	Dan Gurney
Daniel_Ricciardo	Daniel Ricciardo
Daniil_Kvyat	Daniil Kvyat
Danny_Ongais	Danny Ongais
Danny_Sullivan	Danny Sullivan
Dave_Charlton	Dave Charlton
Dave_Morgan	Dave Morgan
David_Brabham	David Brabham
David_Coulthard	David Coulthard
David_Hampshire	David Hampshire
David_Hobbs	David Hobbs
David_Murray	David Murray
David_Piper	David Piper
David_Prophet	David Prophet
David_Purley	David Purley
David_Walker	David Walker
Dempsey_Wilson	Dempsey Wilson
Dennis_Poore	Dennis Poore
Denny_Hulme	Denny Hulme
Derek_Bell	Derek Bell
Derek_Daly	Derek Daly
Derek_Warwick	Derek Warwick
Desmond_Titterington	Desmond Titterington
Dick_Gibson	Dick Gibson
Dick_Rathman	Dick Rathman
Didier_Pironi	Didier Pironi
Dieter_Quester	Dieter Quester
Don_Beauman	Don Beauman
Don_Branson	Don Branson
Don_Edmunds	Don Edmunds
Don_Freeland	Don Freeland
Dorino_Serafini	Dorino Serafini
Doug_Serrurier	Doug Serrurier
Dries_van_der_Lof	Dries van der Lof
Duane_Carter	Duane Carter
Duke_Dinsmore	Duke Dinsmore
Duke_Nalon	Duke Nalon
Duncan_Hamilton	Duncan Hamilton
Eddie_Cheever_Jr	Eddie Cheever, Jr.
Eddie_Irvine	Eddie Irvine
Eddie_Johnson	Eddie Johnson
Eddie_Keizan	Eddie Keizan
Eddie_Russo	Eddie Russo
Eddie_Sachs	Eddie Sachs
Ed_Elisian	Ed Elisian
Edgar_Barth	Edgar Barth
Eitel_Cantoni	Eitel Cantoni
Elie_Bayol	Elie Bayol
Elio_de_Angelis	Elio de Angelis
Eliseo_Salazar	Eliseo Salazar
Elmer_George	Elmer George
Emanuele_Naspetti	Emanuele Naspetti
Emanuele_Pirro	Emanuele Pirro
Emerson_Fittipaldi	Emerson Fittipaldi
Emilio_de_Villota	Emilio de Villota
Enrique_Bernoldi	Enrique Bernoldi
Eppie_Wietzes	Eppie Wietzes
Eric_Bernard	Eric Bernard
Eric_Brandon	Eric Brandon
Eric_Thompson	Eric Thompson
Eric_van_de_Poele	Eric van de Poele
Erik_Comas	Erik Comas
Ernesto_Brambilla	Ernesto Brambilla
Ernie_McCoy	Ernie McCoy
Ernie_Pieterse	Ernie Pieterse
Ernst_Klodwig	Ernst Klodwig
Ernst_Loof	Ernst Loof
Erwin_Bauer	Erwin Bauer
Esteban_Gutierrez	Esteban Gutierrez
Esteban_Ocon	Esteban Ocon
Esteban_Tuero	Esteban Tuero
Ettore_Chimeri	Ettore Chimeri
Eugene_Chaboud	Eugene Chaboud
Eugene_Martin	Eugene Martin
Eugenio_Castellotti	Eugenio Castellotti
Fabrizio_Barbazza	Fabrizio Barbazza
Felice_Bonetto	Felice Bonetto
Felipe_Massa	Felipe Massa
Felipe_Nasr	Felipe Nasr
Fernando_Alonso	Fernando Alonso
Franck_Lagorce	Franck Lagorce
Franck_Montagny	Franck Montagny
Franco_Comotti	Franco Comotti
Franco_Forini	Franco Forini
Francois_Cevert	Francois Cevert
Francois_Hesnault	Francois Hesnault
Francois_Mazet	Francois Mazet
Francois_Migault	Francois Migault
Francois_Picard	Francois Picard
Franco_Rol	Franco Rol
Frank_Armi	Frank Armi
Frank_Dochnal	Frank Dochnal
Frank_Gardner	Frank Gardner
Freddie_Agabashian	Freddie Agabashian
Fred_Gamble	Fred Gamble
Fred_Wacker	Fred Wacker
Fritz_dOrey	Fritz d'Orey
Fritz_Riess	Fritz Riess
Gabriele_Tarquini	Gabriele Tarquini
Gaetano_Starrabba	Gaetano Starrabba
Gaston_Mazzacane	Gaston Mazzacane
Gene_Force	Gene Force
Gene_Hartley	Gene Hartley
Geoff_Crossley	Geoff Crossley
Geoff_Lees	Geoff Lees
George_Abecassis	George Abecassis
George_Amick	George Amick
George_Connor	George Connor
George_Constantine	George Constantine
George_Eaton	George Eaton
George_Follmer	George Follmer
George_Fonder	George Fonder
George_Russell	George Russell
Georges_Berger	Georges Berger
Georges_Grignard	Georges Grignard
Gerard_Larrousse	Gerard Larrousse
Gerhard_Berger	Gerhard Berger
Gerhard_Mitter	Gerhard Mitter
Gerino_Gerini	Gerino Gerini
Gerry_Ashmore	Gerry Ashmore
Giacomo_Russo	Giacomo Russo
Giancarlo_Baghetti	Giancarlo Baghetti
Giancarlo_Fisichella	Giancarlo Fisichella
Gianmaria_Bruni	Gianmaria Bruni
Gianni_Morbidelli	Gianni Morbidelli
Giedo_van_der_Garde	Giedo van der Garde
Gijs_van_Lennep	Gijs van Lennep
Gilles_Villeneuve	Gilles Villeneuve
Gino_Bianco	Gino Bianco
Gino_Munaron	Gino Munaron
Giorgio_Bassi	Giorgio Bassi
Giorgio_Pantano	Giorgio Pantano
Giorgio_Scarlatti	Giorgio Scarlatti
Giovanni_Lavaggi	Giovanni Lavaggi
Giulio_Cabianca	Giulio Cabianca
Graham_Hill	Graham Hill
Graham_McRae	Graham McRae
Graham_Whitehead	Graham Whitehead
Gregor_Foitek	Gregor Foitek
Guanyu_Zhou	Guanyu Zhou
Gunnar_Nilsson	Gunnar Nilsson
Gunther_Bechem	Gunther Bechem
Gus_Hutchison	Gus Hutchison
Guy_Edwards	Guy Edwards
Guy_Ligier	Guy Ligier
Guy_Mairesse	Guy Mairesse
Guy_Tunmer	Guy Tunmer
Hans_Binder	Hans Binder
Hans_Herrmann	Hans Herrmann
Hans_Heyer	Hans Heyer
Hans-Joachim_Stuck	Hans-Joachim Stuck
Hans_Klenk	Hans Klenk
Hans_Stuck	Hans Stuck
Hap_Sharp	Hap Sharp
Harald_Ertl	Harald Ertl
Harry_Blanchard	Harry Blanchard
Harry_Merkel	Harry Merkel
Harry_Schell	Harry Schell
Hector_Rebaque	Hector Rebaque
Heikki_Kovalainen	Heikki Kovalainen
Heini_Walter	Heini Walter
Heinz-Harald_Frentzen	Heinz-Harald Frentzen
Heinz_Schiller	Heinz Schiller
Helm_Glockler	Helm Glockler
Helmuth_Koinigg	Helmuth Koinigg
Helmut_Marko	Helmut Marko
Helmut_Niedermayr	Helmut Niedermayr
Henri_Louveau	Henri Louveau
Henri_Pescarolo	Henri Pescarolo
Henry_Banks	Henry Banks
Henry_Taylor	Henry Taylor
Herbert_MacKay-Fraser	Herbert MacKay-Fraser
Hermann_Lang	Hermann Lang
Hermano_da_Silva_Ramos	Hermano da Silva Ramos
Hideki_Noda	Hideki Noda
Hiroshi_Fushida	Hiroshi Fushida
Horace_Gould	Horace Gould
Howden_Ganley	Howden Ganley
Hubert_Hahne	Hubert Hahne
Huub_Rothengatter	Huub Rothengatter
Ian_Ashley	Ian Ashley
Ian_Burgess	Ian Burgess
Ian_Raby	Ian Raby
Ian_Scheckter	Ian Scheckter
Ian_Stewart	Ian Stewart
Ignazio_Giunti	Ignazio Giunti
Ingo_Hoffmann	Ingo Hoffmann
Innes_Ireland	Innes Ireland
Ivan_Capelli	Ivan Capelli
Ivor_Bueb	Ivor Bueb
Jack_Aitken	Jack Aitken
Jack_Brabham	Jack Brabham
Jack_Fairman	Jack Fairman
Jackie_Holmes	Jackie Holmes
Jackie_Lewis	Jackie Lewis
Jackie_Oliver	Jackie Oliver
Jackie_Pretorius	Jackie Pretorius
Jackie_Stewart	Jackie Stewart
Jack_McGrath	Jack McGrath
Jack_Turner	Jack Turner
Jacky_Ickx	Jacky Ickx
Jacques_Laffite	Jacques Laffite
Jacques_Pollet	Jacques Pollet
Jacques_Swaters	Jacques Swaters
Jacques_Villeneuve	Jacques Villeneuve
Jaime_Alguersuari	Jaime Alguersuari
James_Hunt	James Hunt
Jan_Flinterman	Jan Flinterman
Jan_Lammers	Jan Lammers
Jan_Magnussen	Jan Magnussen
Jarno_Trulli	Jarno Trulli
Jay_Chamberlain	Jay Chamberlain
Jean_Alesi	Jean Alesi
Jean_Behra	Jean Behra
Jean-Christophe_Boullion	Jean-Christophe Boullion
Jean-Claude_Rudaz	Jean-Claude Rudaz
Jean-Denis_Deletraz	Jean-Denis Deletraz
Jean-Eric_Vergne	Jean-Eric Vergne
Jean-Louis_Schlesser	Jean-Louis Schlesser
Jean_Lucas	Jean Lucas
Jean-Marc_Gounon	Jean-Marc Gounon
Jean-Pierre_Beltoise	Jean-Pierre Beltoise
Jean-Pierre_Jabouille	Jean-Pierre Jabouille
Jean-Pierre_Jarier	Jean-Pierre Jarier
Jenson_Button	Jenson Button
Jerome_DAmbrosio	Jerome D'Ambrosio
Jerry_Hoyt	Jerry Hoyt
Jerry_Unser	Jerry Unser
Jesus_Iglesias	Jesus Iglesias
Jim_Crawford	Jim Crawford
Jim_Hall	Jim Hall
Jim_Hurtubise	Jim Hurtubise
Jim_McWithey	Jim McWithey
Jimmy_Bryan	Jimmy Bryan
Jimmy_Clark	Jimmy Clark
Jimmy_Davies	Jimmy Davies
Jimmy_Daywalt	Jimmy Daywalt
Jimmy_Jackson	Jimmy Jackson
Jimmy_Reece	Jimmy Reece
Jimmy_Stewart	Jimmy Stewart
Jim_Rathmann	Jim Rathmann
Jim_Rigsby	Jim Rigsby
J_J_Lehto	J.J. Lehto
Jo_Bonnier	Jo Bonnier
Jochen_Mass	Jochen Mass
Jochen_Rindt	Jochen Rindt
Jody_Scheckter	Jody Scheckter
Joe_Fry	Joe Fry
Joe_James	Joe James
Joe_Kelly	Joe Kelly
Jo_Gartner	Jo Gartner
John_Barber	John Barber
John_Campbell-Jones	John Campbell-Jones
John_Cannon	John Cannon
John_Cordts	John Cordts
John_Fitch	John Fitch
John_James	John James
John_Love	John Love
John_Miles	John Miles
John_Nicholson	John Nicholson
Johnnie_Parsons	Johnnie Parsons
Johnnie_Tolan	Johnnie Tolan
Johnny_Boyd	Johnny Boyd
Johnny_Cecotto	Johnny Cecotto
Johnny_Claes	Johnny Claes
Johnny_Dumfries	Johnny Dumfries
Johnny_Herbert	Johnny Herbert
Johnny_McDowell	Johnny McDowell
Johnny_Servoz-Gavin	Johnny Servoz-Gavin
Johnny_Thomson	Johnny Thomson
John_Rhodes	John Rhodes
John_Riseley-Prichard	John Riseley-Prichard
John_Surtees	John Surtees
John_Taylor	John Taylor
John_Watson	John Watson
Joie_Chitwood	Joie Chitwood
Jolyon_Palmer	Jolyon Palmer
Jonathan_Palmer	Jonathan Palmer
Jonathan_Williams	Jonathan Williams
Jorge_Daponte	Jorge Daponte
Jo_Schlesser	Jo Schlesser
Jose_Dolhem	Jose Dolhem
Josef_Peters	Josef Peters
Jose_Froilan_Gonzalez	Jose Froilan Gonzalez
Jo_Siffert	Jo Siffert
Jos_Verstappen	Jos Verstappen
Jo_Vonlanthen	Jo Vonlanthen
Juan_Jover	Juan Jover
Juan_Manuel_Bordeu	Juan Manuel Bordeu
Juan_Manuel_Fangio	Juan Manuel Fangio
Juan_Pablo_Montoya	Juan Pablo Montoya
Jud_Larson	Jud Larson
Jules_Bianchi	Jules Bianchi
Julian_Bailey	Julian Bailey
Justin_Wilson	Justin Wilson
Kamui_Kobayashi	Kamui Kobayashi
Karl_Kling	Karl Kling
Karl_Wendlinger	Karl Wendlinger
Karun_Chandhok	Karun Chandhok
Kazuki_Nakajima	Kazuki Nakajima
Kazuyoshi_Hoshino	Kazuyoshi Hoshino
Keith_Andrews	Keith Andrews
Keith_Greene	Keith Greene
Keke_Rosberg	Keke Rosberg
Ken_Downing	Ken Downing
Ken_Kavanagh	Ken Kavanagh
Kenneth_McAlpine	Kenneth McAlpine
Kenny_Acheson	Kenny Acheson
Ken_Richardson	Ken Richardson
Ken_Wharton	Ken Wharton
Kevin_Magnussen	Kevin Magnussen
Kimi_Raikkonen	Kimi Raikkonen
Kunimitsu_Takahashi	Kunimitsu Takahashi
Kurt_Adolff	Kurt Adolff
Kurt_Ahrens_Jr	Kurt Ahrens, Jr.
Lamberto_Leoni	Lamberto Leoni
Lance_Macklin	Lance Macklin
Lance_Reventlow	Lance Reventlow
Lance_Stroll	Lance Stroll
Lando_Norris	Lando Norris
Larry_Crockett	Larry Crockett
Larry_Perkins	Larry Perkins
Lee_Wallard	Lee Wallard
Lella_Lombardi	Lella Lombardi
Len_Duncan	Len Duncan
Len_Sutton	Len Sutton
Leo_Kinnunen	Leo Kinnunen
Les_Leston	Les Leston
Leslie_Johnson	Leslie Johnson
Leslie_Marr	Leslie Marr
Leslie_Thorne	Leslie Thorne
Lewis_Hamilton	Lewis Hamilton
Lloyd_Ruby	Lloyd Ruby
Lorenzo_Bandini	Lorenzo Bandini
Loris_Kessel	Loris Kessel
Louis_Chiron	Louis Chiron
Louis_Rosier	Louis Rosier
Luca_Badoer	Luca Badoer
Lucas_di_Grassi	Lucas di Grassi
Luciano_Burti	Luciano Burti
Lucien_Bianchi	Lucien Bianchi
Ludovico_Scarfiotti	Ludovico Scarfiotti
Luigi_Fagioli	Luigi Fagioli
Luigi_Musso	Luigi Musso
Luigi_Piotti	Luigi Piotti
Luigi_Villoresi	Luigi Villoresi
Luis_Perez-Sala	Luis Perez-Sala
Luiz_Bueno	Luiz Bueno
Luki_Botha	Luki Botha
Mack_Hellings	Mack Hellings
Manfred_Winkelhock	Manfred Winkelhock
Manny_Ayulo	Manny Ayulo
Marcel_Balsa	Marcel Balsa
Marc_Gene	Marc Gene
Marco_Apicella	Marco Apicella
Marc_Surer	Marc Surer
Marcus_Ericsson	Marcus Ericsson
Maria_Teresa_de_Filippis	Maria Teresa de Filippis
Mario_Andretti	Mario Andretti
Mario_de_Araujo_Cabral	Mario de Araujo Cabral
Mark_Blundell	Mark Blundell
Mark_Donohue	Mark Donohue
Markus_Winkelhock	Markus Winkelhock
Mark_Webber	Mark Webber
Marshall_Teague	Marshall Teague
Martin_Brundle	Martin Brundle
Martin_Donnelly	Martin Donnelly
Masahiro_Hasemi	Masahiro Hasemi
Massimo_Natili	Massimo Natili
Masten_Gregory	Masten Gregory
Maurice_Trintignant	Maurice Trintignant
Mauricio_Gugelmin	Mauricio Gugelmin
Mauri_Rose	Mauri Rose
Mauro_Baldi	Mauro Baldi
Max_Chilton	Max Chilton
Max_de_Terra	Max de Terra
Max_Jean	Max Jean
Max_Papis	Max Papis
Max_Verstappen	Max Verstappen
Michael_Andretti	Michael Andretti
Michael_Bleekemolen	Michael Bleekemolen
Michael_May	Michael May
Michael_Schumacher	Michael Schumacher
Michael_Thackwell	Michael Thackwell
Michele_Alboreto	Michele Alboreto
Michel_Leclere	Michel Leclere
Mick_Schumacher	Mick Schumacher
Miguel_Angel_Guerra	Miguel Angel Guerra
Mika_Hakkinen	Mika Hakkinen
Mika_Salo	Mika Salo
Mike_Beuttler	Mike Beuttler
Mike_Fisher	Mike Fisher
Mike_Hailwood	Mike Hailwood
Mike_Harris	Mike Harris
Mike_Hawthorn	Mike Hawthorn
Mike_MacDowel	Mike MacDowel
Mike_Magill	Mike Magill
Mike_Nazaruk	Mike Nazaruk
Mike_Parkes	Mike Parkes
Mike_Sparken	Mike Sparken
Mike_Spence	Mike Spence
Mike_Taylor	Mike Taylor
Mike_Wilds	Mike Wilds
Mimmo_Schiattarella	Mimmo Schiattarella
Moises_Solana	Moises Solana
Myron_Fohr	Myron Fohr
Nanni_Galli	Nanni Galli
Narain_Karthikeyan	Narain Karthikeyan
Nasif_Estefano	Nasif Estefano
Nello_Pagani	Nello Pagani
Nelson_Piquet_Jr	Nelson Piquet, Jr.
Nelson_Piquet	Nelson Piquet
Neville_Lederle	Neville Lederle
Nicholas_Latifi	Nicholas Latifi
Nick_Heidfeld	Nick Heidfeld
Nico_Hulkenberg	Nico Hulkenberg
Nicola_Larini	Nicola Larini
Nicolas_Kiesa	Nicolas Kiesa
Nico_Rosberg	Nico Rosberg
Nigel_Mansell	Nigel Mansell
Niki_Lauda	Niki Lauda
Nikita_Mazepin	Nikita Mazepin
Nino_Farina	Nino Farina
Nino_Vaccarella	Nino Vaccarella
Norberto_Fontana	Norberto Fontana
Noritake_Takahara	Noritake Takahara
Olivier_Beretta	Olivier Beretta
Olivier_Gendebien	Olivier Gendebien
Olivier_Grouillard	Olivier Grouillard
Olivier_Panis	Olivier Panis
Onofre_Marimon	Onofre Marimon
Oscar_Galvez	Oscar Galvez
Oscar_Larrauri	Oscar Larrauri
Oswald_Karch	Oswald Karch
Ottorino_Volonterio	Ottorino Volonterio
Otto_Stuppacher	Otto Stuppacher
Pablo_Birger	Pablo Birger
Paco_Godia	Paco Godia
Paddy_Driver	Paddy Driver
Paolo_Barilla	Paolo Barilla
Pascal_Fabre	Pascal Fabre
Pascal_Wehrlein	Pascal Wehrlein
Pastor_Maldonado	Pastor Maldonado
Pat_Flaherty	Pat Flaherty
Pat_OConnor	Pat O'Connor
Patrick_Depailler	Patrick Depailler
Patrick_Friesacher	Patrick Friesacher
Patrick_Gaillard	Patrick Gaillard
Patrick_Neve	Patrick Neve
Patrick_Tambay	Patrick Tambay
Paul_Belmondo	Paul Belmondo
Paul_DiResta	Paul Di Resta
Paul_Emery	Paul Emery
Paul_England	Paul England
Paul_Frere	Paul Frere
Paul_Goldsmith	Paul Goldsmith
Paul_Hawkins	Paul Hawkins
Paul_Pietsch	Paul Pietsch
Paul_Russo	Paul Russo
Pedro_de_la_Rosa	Pedro de la Rosa
Pedro_Diniz	Pedro Diniz
Pedro_Lamy	Pedro Lamy
Pedro_Rodriguez	Pedro Rodriguez
Pete_Lovely	Pete Lovely
Peter_Arundell	Peter Arundell
Peter_Ashdown	Peter Ashdown
Peter_Broeker	Peter Broeker
Peter_Collins	Peter Collins
Peter_de_Klerk	Peter de Klerk
Peter_Gethin	Peter Gethin
Peter_Hirt	Peter Hirt
Peter_Revson	Peter Revson
Peter_Ryan	Peter Ryan
Peter_Walker	Peter Walker
Peter_Whitehead	Peter Whitehead
Phil_Cade	Phil Cade
Phil_Hill	Phil Hill
Philip_Fotheringham-Parker	Philip Fotheringham-Parker
Philippe_Adams	Philippe Adams
Philippe_Alliot	Philippe Alliot
Philippe_Etancelin	Philippe Etancelin
Philippe_Streiff	Philippe Streiff
Piercarlo_Ghinzani	Piercarlo Ghinzani
Pierluigi_Martini	Pierluigi Martini
Piero_Carini	Piero Carini
Piero_Drogo	Piero Drogo
Piero_Scotti	Piero Scotti
Piero_Taruffi	Piero Taruffi
Pierre_Gasly	Pierre Gasly
Pierre-Henri_Raphanel	Pierre-Henri Raphanel
Pierre_Levegh	Pierre Levegh
Piers_Courage	Piers Courage
Pietro_Fittipaldi	Pietro Fittipaldi
Prince_Bira	Prince Bira
Ralf_Schumacher	Ralf Schumacher
Ralph_Firman	Ralph Firman
Raul_Boesel	Raul Boesel
Ray_Crawford	Ray Crawford
Raymond_Sommer	Raymond Sommer
Red_Amick	Red Amick
Reg_Parnell	Reg Parnell
Reine_Wisell	Reine Wisell
Renato_Pirocchi	Renato Pirocchi
Rene_Arnoux	Rene Arnoux
Renzo_Zorzi	Renzo Zorzi
Ricardo_Rodriguez	Ricardo Rodriguez
Ricardo_Rosset	Ricardo Rosset
Ricardo_Zonta	Ricardo Zonta
Ricardo_Zunino	Ricardo Zunino
Riccardo_Paletti	Riccardo Paletti
Riccardo_Patrese	Riccardo Patrese
Richard_Attwood	Richard Attwood
Richard_Robarts	Richard Robarts
Richie_Ginther	Richie Ginther
Rikky_von_Opel	Rikky von Opel
Rio_Haryanto	Rio Haryanto
Robert_Doornbos	Robert Doornbos
Robert_Kubica	Robert Kubica
Robert_La_Caze	Robert La Caze
Robert_Manzon	Robert Manzon
Roberto_Bonomi	Roberto Bonomi
Robert_OBrien	Robert O'Brien
Roberto_Bussinello	Roberto Bussinello
Roberto_Guerrero	Roberto Guerrero
Roberto_Lippi	Roberto Lippi
Roberto_Merhi	Roberto Merhi
Roberto_Mieres	Roberto Mieres
Roberto_Moreno	Roberto Moreno
Robin_Montgomerie-Charrington	Robin Montgomerie-Charrington
Robin_Widdows	Robin Widdows
Rob_Schroeder	Rob Schroeder
Rodger_Ward	Rodger Ward
Rodney_Nuckey	Rodney Nuckey
Roelof_Wunderink	Roelof Wunderink
Roger_Laurent	Roger Laurent
Roger_Loyer	Roger Loyer
Roger_Penske	Roger Penske
Roger_Williamson	Roger Williamson
Roland_Ratzenberger	Roland Ratzenberger
Rolf_Stommelen	Rolf Stommelen
Romain_Grosjean	Romain Grosjean
Ron_Flockhart	Ron Flockhart
Ronnie_Bucknum	Ronnie Bucknum
Ronnie_Peterson	Ronnie Peterson
Roy_Salvadori	Roy Salvadori
Rubens_Barrichello	Rubens Barrichello
Rudi_Fischer	Rudi Fischer
Rudolf_Krause	Rudolf Krause
Rudolf_Schoeller	Rudolf Schoeller
Rupert_Keegan	Rupert Keegan
Sakon_Yamamoto	Sakon Yamamoto
Sam_Hanks	Sam Hanks
Sam_Posey	Sam Posey
Sam_Tingle	Sam Tingle
Satoru_Nakajima	Satoru Nakajima
Scott_Speed	Scott Speed
Sebastian_Vettel	Sebastian Vettel
Sebastien_Bourdais	Sebastien Bourdais
Sebastien_Buemi	Sebastien Buemi
Sergey_Sirotkin	Sergey Sirotkin
Sergio_Mantovani	Sergio Mantovani
Sergio_Perez	Sergio Perez
Shinji_Nakano	Shinji Nakano
Shorty_Templeman	Shorty Templeman
Siegfried_Stohr	Siegfried Stohr
Silvio_Moser	Silvio Moser
Skip_Barber	Skip Barber
Slim_Borgudd	Slim Borgudd
Spider_Webb	Spider Webb
Stefan_Bellof	Stefan Bellof
Stefan_Johansson	Stefan Johansson
Stefano_Modena	Stefano Modena
Stephane_Sarrazin	Stephane Sarrazin
Stirling_Moss	Stirling Moss
Stoffel_Vandoorne	Stoffel Vandoorne
Stuart_Lewis-Evans	Stuart Lewis-Evans
Taki_Inoue	Taki Inoue
Takuma_Sato	Takuma Sato
Tarso_Marques	Tarso Marques
Teddy_Pilette	Teddy Pilette
Teo_Fabi	Teo Fabi
Theo_Fitzau	Theo Fitzau
Theo_Helfrich	Theo Helfrich
Thierry_Boutsen	Thierry Boutsen
Tiago_Monteiro	Tiago Monteiro
Tiff_Needell	Tiff Needell
Tim_Mayer	Tim Mayer
Timo_Glock	Timo Glock
Tim_Parnell	Tim Parnell
Tim_Schenken	Tim Schenken
Tomas_Enge	Tomas Enge
Tom_Belso	Tom Belso
Tom_Bridger	Tom Bridger
Tommy_Byrne	Tommy Byrne
Tom_Pryce	Tom Pryce
Toni_Branca	Toni Branca
Toni_Ulmen	Toni Ulmen
Tony_Bettenhausen	Tony Bettenhausen
Tony_Brise	Tony Brise
Tony_Brooks	Tony Brooks
Tony_Crook	Tony Crook
Tony_Gaze	Tony Gaze
Tony_Maggs	Tony Maggs
Tony_Marsh	Tony Marsh
Tony_Rolt	Tony Rolt
Tony_Settember	Tony Settember
Tony_Shelly	Tony Shelly
Tora_Takagi	Tora Takagi
Torsten_Palm	Torsten Palm
Toshio_Suzuki	Toshio Suzuki
Toulo_de_Graffenried	Toulo de Graffenried
Trevor_Blokdyk	Trevor Blokdyk
Trevor_Taylor	Trevor Taylor
Troy_Ruttman	Troy Ruttman
Ukyo_Katayama	Ukyo Katayama
Umberto_Maglioli	Umberto Maglioli
Valtteri_Bottas	Valtteri Bottas
Vern_Schuppan	Vern Schuppan
Vic_Elford	Vic Elford
Vic_Wilson	Vic Wilson
Vitaly_Petrov	Vitaly Petrov
Vitantonio_Liuzzi	Vitantonio Liuzzi
Vittorio_Brambilla	Vittorio Brambilla
Walt_Ader	Walt Ader
Walt_Brown	Walt Brown
Walt_Faulkner	Walt Faulkner
Walt_Hansgen	Walt Hansgen
Warwick_Brown	Warwick Brown
Wayne_Weiler	Wayne Weiler
William_Ferguson	William Ferguson
Willi_Heeks	Willi Heeks
Willi_Krakau	Willi Krakau
Will_Stevens	Will Stevens
Willy_Mairesse	Willy Mairesse
Wilson_Fittipaldi	Wilson Fittipaldi
Wolfgang_Seidel	Wolfgang Seidel
Wolfgang_von_Trips	Wolfgang von Trips
Yannick_Dalmas	Yannick Dalmas
Yuji_Ide	Yuji Ide
Yuki_Tsunoda	Yuki Tsunoda
Yves_Giraud-Cabantous	Yves Giraud-Cabantous
Zsolt_Baumgartner	Zsolt Baumgartner
